11111111111111111111111111111111111
10000000000000000000000000000000001
10000000000000000000000000000000001
10000000000000000000000000000000001
10000000000000000200000000000000001
10000000000000000200000000000000001
10000000000000000200000000000000001
10000000000000000200000000000000001
10000000000000000200000000000000001
10000000000000000200000000000000001
10000000000000000200000000000000001
10000000000000000200000000000000001
10000000000000000200000000000000001
10000000000000000200000000000000001
10000000000000000200000000000000001
10000000000000022222000000000000001
10000000000000020002000000000000001
10002222222222220302222222222220001
10000000000000020002000000000000001
10000000000000022222000000000000001
10000000000000000200000000000000001
10000000000000000200000000000000001
10000000000000000200000000000000001
10000000000000000200000000000000001
10000000000000000200000000000000001
10000000000000000200000000000000001
10000000000000000200000000000000001
10000000000000000200000000000000001
10000000000000000200000000000000001
10000000000000000200000000000000001
10000000000000000200000000000000001
10000000000000000000000000000000001
10000000000000000000000000000000001
10000000000000000000000000000000001
11111111111111111111111111111111111